1,1,1,1,1,1,0,1,1,1,1,1,1,5,5,5
1,1,0,0,0,1,3,1,1,1,1,1,1,5,5,5
1,0,3,0,0,0,3,0,1,1,1,1,1,5,5,5
0,4,4,1,4,0,2,0,0,0,0,0,0,5,5,5
1,1,0,1,1,1,0,1,1,0,1,1,1,5,5,5
1,1,0,1,1,1,0,1,1,0,1,1,1,5,5,5
1,1,0,0,0,0,3,0,0,0,1,1,1,5,5,5
1,1,0,0,1,1,4,1,1,1,1,1,1,5,5,5
1,1,1,1,1,1,0,1,1,1,1,1,1,5,5,5
