1,1,1,1,1,1,1,0,1,0,1,1,1,5,5,5
1,1,1,1,1,1,1,0,1,0,1,1,1,5,5,5
0,4,1,1,1,1,1,2,3,0,0,0,0,5,5,5
1,4,4,0,0,0,0,3,3,1,1,1,1,5,5,5
1,4,0,0,0,1,1,0,3,0,1,1,1,5,5,5
1,1,1,1,0,1,1,0,1,0,1,1,1,5,5,5
1,1,1,1,0,1,1,0,1,0,1,1,1,5,5,5
1,1,1,1,0,0,0,0,1,0,1,1,1,5,5,5
1,1,1,1,1,1,1,0,1,0,1,1,1,5,5,5
